

___________________________________________________________________________________________________________________________________________________________________________________________________________________________________________________________________________________________________________
|                                                                                                                                                                                                                                                                                                           |
|                                                                                                                                                                                                                                                                                                           |
|                                                                                                                                                                                                                                                                                                           |
|                                                                                                ______________________                                                                                                             __________________________________________________________              |
|                                                                                               /                      |                                                                                                           |_|   ______________________________                      |_|            |
|                                                                                              /                       |                                                                                                           |_|   |                            |                      |_|            |
|                                                                                             |                        |__________________                                                                                         |_|   |          [W]       [L]     |                      |_|            |
|                                                                                             |           [g]          ?  [l] [l]     [G] \                                                                                        |_|   |                            |                      |_|            |
|                                                                                             |                        ?______________     \             ____________________                                                      |_|   |                            |                      |_|            |
|                                                                                              \                       |              \     \           /                    \                                                     |_|   |_________     ______________|                      |_|            |
|                                                                                               \   [s]                |               \ [o] \         /                      \                                                    |_|             \   /                                     |_|            |
|                                                                                                \     ________________|                \ [z] \       /                        \                                                   |_|          ____|?|____                                  |_|            |
|                                                   _________________________                    /    /                                  \     \     |                  [o]     |               -------                            |_|         /           |                                 |_|            |
|                                                  |     [l]               |_|                  /    /                                    \ [r] \    |                          |              |       |                   ________|_|________/            |                                 |_|            |
|                                                  |           _____       |_|                 /    /                                      \     \   |        [s]               |______________|  [o]  |                  /              [z]  ?    [g/we]  #                   [P]           |_|            |
|                                                  |          |     |      |_|________________/  1 /________________________________________      ----        [s]  [D]          ? [l][L][l][G]    [o]  |                 /     _______________?            #                                 |_|            |
|          _______________                         |          | [w] |       ?|_____[o]____[o]_     #____________________________________      ________        [s]               ?_______________  [o]  |                 | [L] |   |_|        \            |                                 |_|            |
|         /   _____z___   |                        |          |_____|      |_|                |  3  |                                  /     /        |                         |              |       |                 |     |   |_|         \____|?|____|                                 |_|            |
|        |   |         \  |                        |      [l]              |_|                |     |                                 /     /         |                         |              |___?___|                 |     |   |_|             /   \                                     |_|            |
|        |   |         |  \________________________/    /__________________|_|               /       \                               / [r] /          |                  [z]    |                 | |                    | [o] |   |_|    _________|   |______________                       |_|            |
|    ____| n |____     \_____[s]________ [r] _____ [G] /                                     |       |                              /     /            \                        /                /   \                   |--?--|   |_|   |                            |                      |_|            |
|   |_|    .    |_|_______________      |    |    |  |                                       |       |                             /     /              \                      /           _____/     \_____             | [z] |   |_|   |                            |                      |_|            |
|   |_|    R1  . w _____ [s]___   \     |    |   /   |                                       |       |                            /     /                \____________________/            |                |            |--?--|   |_|   |           [P]        [L]   |                      |_|            |
|   |_|    .    |_|           |   |     / z /   /    |                                       |       |                           /  *  /                                                   |                |            | [s] |   |_|   |                            |                      |_|            |
|   |_|__| e ___|_|           |   |    / z /   /    /                                        |  we   |                          /  *  /                                                    |       [V]      |            |     |   |_|   |____________________________|                      |_|            |
|   |      [G]     \          |   |   / z /   /    /                                         |       |                         /     /                                                     |                |            |     |   |_|_______________________________________________________|_|            |
|   | [c] _____ [c] \          \  |__/   /    |   /                                          |___?___|                        /     /                                                      |_______??_______|            |     |                                                                            |
|   |    /    |     |           \   s   /     /z /                                           |       |                       /     /                                                              |[G]\                  |     |                                                                            |
|   |   \     |  *  |            \_ r _/     /  /                                            |  [l]  _______________________/     /                                                               |    \_________________|     |                                                                            |
|    \ * \    |     |              |  |     /  /                                             |  [l]          [z]      [G]        /                                                                |____________________________|                                                                            |
|     \   \   |  *  |              |  |    /  /                                              |__________________________________/                                                                                                                                                                           |
|     |   |   |     |              |  |___/  /                                                                                                                                                                                                                                                              |
|     |   |    \   /               \________/                                                                                                                                                                                                                                                               |
|_____| l |____| r |__________________________________                                                                                                                                                                                                                                                      |
|                                                     |                                                                                                                                                                                                                                                     |
|___________________________________________________________________________________________________________________________________________________________________________________________________________________________________________________________________________________________________________|

Legends:
n     - North
w     - West
l     - Left
r     - Right
*     - Goblin
[G]   - Goldsmith
[s]   - Skeleton
z     - Zombies
[l]   - Loot
[w]   - Witch
?     - Locked Door
[o]   - Ogre
we    - WereWolf
[g]   - Golem
[D]   - Dragon
[P]   - Phoenix
[L]   - Large Loot
[r]   - rubies
[c]   - coins
[V]   - Vampire
#     - Locked Door (Only open with a key)
[W]   - Wizard
[P]   - Pharaoh